TILEMAP
20 20 							-- Size of tile map in tiles
24 24 							-- Tile size & block size
images/baba.png 	-- Tilesheet
32 66 								-- Number of tiles in tilesheet
1657,1657,1657,1657,1657,1657,1657,1657,1657,1657,1657,1657,1657,1657,1657,1657,1657,1657,1657,1657,
1657,0,0,0,0,0,0,0,0,0,0,0,0,0,0,1841,1084,979,1357,1657,
1657,0,0,0,962,868,1068,979,1357,0,0,0,0,0,0,1841,1068,979,1254,1657,
1657,0,0,0,0,0,0,0,0,0,0,0,0,0,0,1841,985,979,1254,1657,
1657,0,0,0,0,0,0,0,0,0,0,0,0,0,0,1841,1841,1841,1841,1657,
1657,0,0,0,0,0,1,0,0,0,0,0,0,0,0,0,0,0,0,1657,
1657,0,0,0,0,0,0,0,0,0,0,0,692,692,692,692,692,692,692,1657,
1657,0,0,0,0,0,0,0,0,0,0,0,692,0,0,0,0,0,0,1657,
1657,0,0,871,979,1365,0,0,0,0,0,0,692,0,0,0,0,0,0,1657,
1657,0,0,0,0,0,0,0,0,1256,0,0,692,0,0,0,679,0,0,1657,
1657,0,0,0,0,0,0,0,0,0,0,0,692,0,0,0,0,0,0,1657,
1657,0,0,0,0,0,0,0,0,0,0,0,692,0,0,0,0,0,0,1657,
1657,688,688,688,688,688,688,688,688,688,688,688,688,688,688,688,688,688,688,1657,
1657,0,0,0,0,0,0,0,0,0,0,0,0,0,0,0,0,0,0,1657,
1657,0,0,0,0,0,0,0,0,0,0,0,0,0,0,0,0,0,0,1657,
1657,0,0,0,0,1362,0,0,0,0,0,0,0,0,0,0,0,0,0,1657,
1657,0,0,0,0,0,0,0,0,0,0,0,0,0,0,0,0,0,0,1657,
1657,0,0,0,0,0,0,0,0,0,0,0,0,0,0,0,0,0,0,1657,
1657,0,0,0,0,0,0,0,0,0,0,0,0,0,0,0,0,0,0,1657,
1657,1657,1657,1657,1657,1657,1657,1657,1657,1657,1657,1657,1657,1657,1657,1657,1657,1657,1657,1657,